1111111111111
10010C00000C1
100C011111001
1P00111E00001
1111111111111