1111111111111111111111111
100000C000000000000000P11
1001110001111000000111111
1CC1111100000000111111111
110000000000111100000E111
1100000000000000000000001
110000000C00000C000000001
1111111111111111111111111