11111111111
10C00000P01
1001CEC0011
11C00000C11
11111111111
